#######
#A    #
# ## ##
#    B#
#######
